NIRQ	ff09	EOSENTRY_DONT_PATCH	N_CBM_IO_C65
MONITOR_BRK	ff0b	EOSENTRY_DONT_PATCH	N_CBM_IO_C65
NNMI	ff0d	EOSENTRY_DONT_PATCH	N_CBM_IO_C65
NOPEN	ff0f	EOSENTRY_DONT_PATCH	N_CBM_IO_C65
NCLOSE	ff11	EOSENTRY_DONT_PATCH	N_CBM_IO_C65
NCHKIN	ff13	EOSENTRY_DONT_PATCH	N_CBM_IO_C65
NCKOUT	ff15	EOSENTRY_DONT_PATCH	N_CBM_IO_C65
NCLRCH	ff17	EOSENTRY_DONT_PATCH	N_CBM_IO_C65
NBASIN	ff19	EOSENTRY_DONT_PATCH	N_CBM_IO_C65
NBSOUT	ff1b	EOSENTRY_DONT_PATCH	N_CBM_IO_C65
NSTOP	ff1d	EOSENTRY_DONT_PATCH	N_CBM_IO_C65
NGETIN	ff1f	EOSENTRY_DONT_PATCH	N_CBM_IO_C65
NCLALL	ff21	EOSENTRY_DONT_PATCH	N_CBM_IO_C65
MONITOR_PARSER	ff23	EOSENTRY_DONT_PATCH	N_CBM_IO_C65
NLOAD	ff25	EOSENTRY_DONT_PATCH	N_CBM_IO_C65
NSAVE	ff27	EOSENTRY_DONT_PATCH	N_CBM_IO_C65
ITALK	ff29	EOSENTRY_DONT_PATCH	N_CBM_IO_C65
ILISTEN	ff2b	EOSENTRY_DONT_PATCH	N_CBM_IO_C65
ITALKSA	ff2d	EOSENTRY_DONT_PATCH	N_CBM_IO_C65
ISECOND	ff2f	EOSENTRY_DONT_PATCH	N_CBM_IO_C65
IACPTR	ff31	EOSENTRY_DONT_PATCH	N_CBM_IO_C65
ICIOUT	ff33	EOSENTRY_DONT_PATCH	N_CBM_IO_C65
IUNTALK	ff35	EOSENTRY_DONT_PATCH	N_CBM_IO_C65
IUNLISTEN	ff37	EOSENTRY_DONT_PATCH	N_CBM_IO_C65
DOS_TALK	ff39	EOSENTRY_DONT_PATCH	N_CBM_IO_C65
DOS_LISTEN	ff3b	EOSENTRY_DONT_PATCH	N_CBM_IO_C65
DOS_TALKSA	ff3d	EOSENTRY_DONT_PATCH	N_CBM_IO_C65
DOS_SECOND	ff3f	EOSENTRY_DONT_PATCH	N_CBM_IO_C65
DOS_ACPTR	ff41	EOSENTRY_DONT_PATCH	N_CBM_IO_C65
DOS_CIOUT	ff43	EOSENTRY_DONT_PATCH	N_CBM_IO_C65
DOS_UNTALK	ff45	EOSENTRY_DONT_PATCH	N_CBM_IO_C65
DOS_UNLISTEN	ff47	EOSENTRY_DONT_PATCH	N_CBM_IO_C65
GET_DOS	ff49	EOSENTRY_DONT_PATCH	N_CBM_IO_C65
LEAVE_DOS	ff4b	EOSENTRY_DONT_PATCH	N_CBM_IO_C65
SPIN_SPOUT	ff4d	EOSENTRY_DONT_PATCH	N_CBM_IO_C65
CLOSE_ALL	ff50	EOSENTRY_DONT_PATCH	N_CBM_IO_C65
C64MODE	ff53	EOSENTRY_DONT_PATCH	N_CBM_IO_C65
MONITOR_CALL	ff56	EOSENTRY_DONT_PATCH	N_CBM_IO_C65
BOOTSYS	ff59	EOSENTRY_DONT_PATCH	N_CBM_IO_C65
PHOENIX	ff5c	EOSENTRY_DONT_PATCH	N_CBM_IO_C65
LKUPLA	ff5f	EOSENTRY_DONT_PATCH	N_CBM_IO_C65
LKUPSA	ff62	EOSENTRY_DONT_PATCH	N_CBM_IO_C65
LDA_FAR	ff64	EOSENTRY_DONT_PATCH	N_CBM_IO_C65
SWAPPER	ff65	EOSENTRY_DONT_PATCH	N_CBM_IO_C65
PFKEY	ff68	EOSENTRY_DONT_PATCH	N_CBM_IO_C65
SETBNK	ff6b	EOSENTRY_DONT_PATCH	N_CBM_IO_C65
JSR_FAR	ff6e	EOSENTRY_DONT_PATCH	N_CBM_IO_C65
JMP_FAR	ff71	EOSENTRY_DONT_PATCH	N_CBM_IO_C65
STA_FAR	ff77	EOSENTRY_DONT_PATCH	N_CBM_IO_C65
CMP_FAR	ff7a	EOSENTRY_DONT_PATCH	N_CBM_IO_C65
CINT	ff81	EOSENTRY_DONT_PATCH	N_CBM_IO_ALL
IOINIT	ff84	EOSENTRY_DONT_PATCH	N_CBM_IO_ALL
RAMTAS	ff87	EOSENTRY_DONT_PATCH	N_CBM_IO_ALL
RESTOR	ff8a	EOSENTRY_DONT_PATCH	N_CBM_IO_ALL
VECTOR	ff8d	EOSENTRY_DONT_PATCH	N_CBM_IO_ALL
SETMSG	ff90	EOSENTRY_DONT_PATCH	N_CBM_IO_ALL
SECOND	ff93	EOSENTRY_DONT_PATCH	N_CBM_IO_ALL
TKSA	ff96	EOSENTRY_DONT_PATCH	N_CBM_IO_ALL
MEMTOP	ff99	EOSENTRY_DONT_PATCH	N_CBM_IO_ALL
MEMBOT	ff9c	EOSENTRY_DONT_PATCH	N_CBM_IO_ALL
SCNKEY	ff9f	EOSENTRY_DONT_PATCH	N_CBM_IO_ALL
SETTMO	ffa2	EOSENTRY_DONT_PATCH	N_CBM_IO_ALL
ACPTR	ffa5	EOSENTRY_DONT_PATCH	N_CBM_IO_ALL
CIOUT	ffa8	EOSENTRY_DONT_PATCH	N_CBM_IO_ALL
UNTLK	ffab	EOSENTRY_DONT_PATCH	N_CBM_IO_ALL
UNLSN	ffae	EOSENTRY_DONT_PATCH	N_CBM_IO_ALL
LISTEN	ffb1	EOSENTRY_DONT_PATCH	N_CBM_IO_ALL
TALK	ffb4	EOSENTRY_DONT_PATCH	N_CBM_IO_ALL
READST	ffb7	EOSENTRY_PATCH	N_CBM_IO_ALL
SETLFS	ffba	EOSENTRY_PATCH	N_CBM_IO_ALL
SETNAM	ffbd	EOSENTRY_PATCH	N_CBM_IO_ALL
OPEN	ffc0	EOSENTRY_PATCH	N_CBM_IO_ALL
CLOSE	ffc3	EOSENTRY_PATCH	N_CBM_IO_ALL
CHKIN	ffc6	EOSENTRY_PATCH	N_CBM_IO_ALL
CHKOUT	ffc9	EOSENTRY_PATCH	N_CBM_IO_ALL
CLRCHN	ffcc	EOSENTRY_PATCH	N_CBM_IO_ALL
CHRIN	ffcf	EOSENTRY_PATCH	N_CBM_IO_ALL
CHROUT	ffd2	EOSENTRY_PATCH	N_CBM_IO_ALL
LOAD	ffd5	EOSENTRY_PATCH	N_CBM_IO_ALL
SAVE	ffd8	EOSENTRY_DONT_PATCH	N_CBM_IO_ALL
SETTIM	ffdb	EOSENTRY_DONT_PATCH	N_CBM_IO_ALL
RDTIM	ffde	EOSENTRY_DONT_PATCH	N_CBM_IO_ALL
STOP	ffe1	EOSENTRY_DONT_PATCH	N_CBM_IO_ALL
GETIN	ffe4	EOSENTRY_DONT_PATCH	N_CBM_IO_ALL
CLALL	ffe7	EOSENTRY_PATCH	N_CBM_IO_ALL
UDTIM	ffea	EOSENTRY_DONT_PATCH	N_CBM_IO_ALL
SCREEN	ffed	EOSENTRY_DONT_PATCH	N_CBM_IO_ALL
PLOT	fff0	EOSENTRY_DONT_PATCH	N_CBM_IO_ALL
IOBASE	fff3	EOSENTRY_DONT_PATCH	N_CBM_IO_ALL
C65MODE	fff6	EOSENTRY_DONT_PATCH	N_CBM_IO_C65
C64MODE	fff8	EOSENTRY_DONT_PATCH	N_CBM_IO_C65
NMI	fffa	EOSENTRY_DONT_PATCH	N_CBM_IO_ALL
RESET	fffc	EOSENTRY_DONT_PATCH	N_CBM_IO_ALL
IRQ	fffe	EOSENTRY_DONT_PATCH	N_CBM_IO_ALL
